Enact\ (new\ process)=Enact (new process)
aString=AString
actorType=ActorType
addActorType=AddActorType
addAllowedActor=AddAllowedActor
addAllowedActorType=AddAllowedActorType
addParentActorType=AddParentActorType
addProducedArtifactType=AddProducedArtifactType
addToPerformingActors=AddToPerformingActors
addToProducedArtifacts=AddToProducedArtifacts
addToUsedArtifacts=AddToUsedArtifacts
addUsedArtifactType=AddUsedArtifactType
artifactType=ArtifactType
beginDate=BeginDate
completed=Completed
creator=Creator
endDate=EndDate
expectedDuration=ExpectedDuration
finishTask=FinishTask
invalid_parameter=Invalid parameter
isCritical=IsCritical
isSenior=IsSenior
isStartable=IsStartable
is_active=Is active
last_updated=Last updated
newProcess=NewProcess
performers=Performers
performingActors=PerformingActors
s=S
st=St
sta=Sta
star=Star
start=Start
startD=StartD
startDa=StartDa
startDat=StartDat
startDate=StartDate
startTask=StartTask
taskType=TaskType
testIsAuthorized=TestIsAuthorized
this=This
update=Update
